x	x	x	R	R	R	x	x	x
x	x	G	G	G	G	G	x	x
x	x	V	V	V	V	V	x	x
x	x	x	R	R	R	x	x	x
R	R	W	R	R	R	W	R	R
Y	R	R	W	W	W	R	R	Y
Y	x	R	R	W	R	R	x	Y
Y	x	x	R	R	R	x	x	Y
x	x	R	R	R	R	x	x	x
x	x	R	R	x	R	R	x	x
x	x	R	R	x	Y	Y	Y	x
x	x	R	R	x	x	x	x	x
x	Y	Y	Y	x	x	x	x	x
