x	x	x	x	x	O	O	O	x	x	x	x	x
x	x	x	x	x	x	R	x	x	x	x	x	x
x	x	x	x	x	x	R	x	x	x	x	x	x
G	G	G	G	G	G	G	G	G	G	G	G	G
G	G	G	G	G	G	G	G	G	G	G	G	G
G	G	x	G	G	G	G	G	G	G	x	G	G
G	G	x	G	G	G	G	G	G	G	x	G	G
G	G	x	G	G	G	G	G	G	G	x	G	G
G	G	G	G	G	G	G	G	G	G	G	G	G
G	x	G	G	G	G	G	G	G	G	G	x	G
G	x	G	x	R	R	x	R	R	x	G	x	G
x	x	R	R	R	R	x	R	R	x	x	x	x
x	x	x	x	x	x	x	R	R	x	x	x	x
x	x	x	x	x	x	x	R	R	x	x	x	x
x	x	x	x	x	x	x	R	R	x	x	x	x
x	x	x	x	x	x	x	R	R	R	R	x	x
