x	O	O	O	x
x	O	O	W	x
x	O	O	O	x
x	x	O	x	x
x	R	R	R	x
x	R	W	R	x
x	R	W	R	x
x	x	R	x	x
x	x	R	x	x
x	x	W	W	x
x	x	x	x	x
