x	x	Y	Y	Y	x	x
x	Y	O	O	O	Y	x
x	Y	G	O	G	Y	x
Y	Y	O	O	O	Y	Y
P	P	P	P	P	P	P
O	x	P	P	P	x	O
O	x	x	P	x	x	O
W	x	P	P	P	x	W
G	P	P	P	P	P	x
G	x	W	x	W	x	x
x	x	W	x	W	x	x
x	x	W	x	W	x	x
x	P	P	x	P	P	x
x	x	x	x	x	x	x
