x	x	Y	Y	Y	x	x
x	Y	Y	Y	Y	Y	x
x	Y	Y	Y	Y	Y	x
Y	Y	Y	Y	Y	Y	Y
P	P	P	P	P	P	P
O	x	P	P	P	x	O
O	x	x	P	x	x	O
W	x	P	P	P	x	W
x	P	P	P	P	P	G
x	x	W	x	W	x	G
x	x	W	x	W	x	x
x	x	W	x	W	x	x
x	P	P	x	P	P	x
x	x	x	x	x	x	x
