x	x	x	Y	Y	x	x
x	x	Y	Y	O	x	x
x	x	Y	O	G	x	x
x	Y	Y	O	O	x	x
x	x	P	P	x	x	x
x	O	P	P	P	x	x
x	O	P	P	x	x	x
x	W	P	P	P	W	x
G	G	G	P	P	P	x
G	G	G	x	W	x	x
x	x	W	x	x	W	x
x	x	W	x	x	W	x
x	x	P	P	x	P	P
x	x	x	x	x	x	x
