x	x	Y	Y	x	x	x
x	x	O	Y	Y	x	x
x	x	G	O	Y	x	x
x	x	O	O	Y	Y	x
x	x	x	P	P	x	x
x	x	O	P	P	O	x
x	O	O	P	P	O	x
x	W	P	P	P	W	x
x	P	P	P	P	P	G
x	x	W	x	W	G	G
x	W	x	x	W	x	x
x	W	x	x	W	x	x
P	P	x	P	P	x	x
x	x	x	x	x	x	x
