x	x	x	x	x	x	x	R	x	x	x	x	x	x	x
x	x	x	x	x	x	R	R	R	x	x	x	x	x	x
x	x	x	x	x	x	x	x	x	x	x	x	x	x	x
x	x	x	x	x	x	x	x	x	x	x	x	x	x	x
x	x	x	x	x	x	x	x	x	x	x	x	x	x	x
x	x	x	x	x	x	x	x	x	x	x	x	x	x	x
x	R	x	x	x	x	x	x	x	x	x	x	x	R	x
R	R	x	x	x	x	x	x	x	x	x	x	x	R	R
x	R	x	x	x	x	x	x	x	x	x	x	x	R	x
x	x	x	x	x	x	x	x	x	x	x	x	x	x	x
x	x	x	x	x	x	x	x	x	x	x	x	x	x	x
x	x	x	x	x	x	x	x	x	x	x	x	x	x	x
x	x	x	x	x	x	x	x	x	x	x	x	x	x	x
x	x	x	x	x	x	R	R	R	x	x	x	x	x	x
x	x	x	x	x	x	x	R	x	x	x	x	x	x	x
