x	x	x	x	x	x	R	R	x	x	x	x	x
x	x	x	x	x	x	R	R	x	x	x	x	x
x	x	x	x	R	R	R	R	R	R	x	x	x
x	x	x	x	R	G	G	G	G	R	x	x	x
x	x	x	x	R	R	R	R	R	R	x	x	x
x	x	x	x	B	W	B	W	B	W	x	x	x
x	x	x	x	x	B	W	B	W	x	x	x	x
x	x	x	x	x	x	x	x	x	x	x	x	x
x	x	x	x	x	x	x	x	x	x	x	x	x
x	x	x	x	x	x	x	x	x	x	x	x	x
x	x	x	x	x	x	x	x	x	x	x	x	x
x	x	x	x	x	x	x	x	x	x	x	x	x
x	x	x	x	x	x	x	x	x	x	x	x	x
x	x	x	x	x	x	x	x	x	x	x	x	x
x	x	x	x	x	x	x	x	x	x	x	x	x
x	x	x	x	x	x	x	x	x	x	x	x	x
