x	x	x	Y	Y	Y	x	x	x
x	x	x	Y	Y	Y	x	x	x
x	x	x	O	Y	O	x	x	x
x	B	B	B	B	B	B	B	x
x	B	B	B	B	B	B	B	x
x	B	x	B	B	B	x	B	x
x	B	x	B	B	B	x	O	x
x	O	x	B	B	B	x	x	x
g	g	x	B	B	B	x	x	x
g	g	x	B	x	B	x	x	x
g	g	O	O	x	B	x	x	x
x	x	x	x	x	B	x	x	x
x	x	x	x	x	O	x	x	x
