x	x	x	Y	Y	O	x	x	x
x	x	x	Y	O	W	x	x	x
x	x	x	Y	O	O	x	x	x
x	x	x	B	B	B	x	x	x
x	x	x	B	B	B	x	x	x
x	x	x	B	B	B	x	x	x
x	x	x	B	B	B	x	x	x
x	x	x	B	O	B	x	x	x
x	x	x	g	B	g	g	x	x
x	x	x	g	B	g	g	x	x
x	x	x	g	B	g	g	x	x
x	x	x	x	O	O	x	x	x
x	x	x	x	x	x	x	x	x
