x	x	x	x	x	x	x	x	x
x	x	x	x	x	x	x	x	x
x	x	x	x	x	x	x	x	x
x	x	x	x	x	x	x	x	x
x	x	x	x	g	x	x	x	x
x	x	x	g	R	g	x	x	x
x	x	x	x	g	x	x	x	x
x	x	x	W	B	W	x	x	x
x	x	x	x	U	x	x	x	x
x	x	x	x	x	x	x	x	x
x	x	x	x	x	x	x	x	x
