x	O	O	O	x
x	O	O	O	x
x	O	O	O	x
x	x	O	x	x
W	R	R	R	R
W	R	R	R	W
x	R	R	R	W
x	R	x	R	x
x	R	x	W	W
x	R	x	x	x
W	W	x	x	x
