x	O	O	O	x
x	O	O	O	x
x	O	O	O	x
x	x	O	x	x
R	R	R	R	R
W	R	R	R	W
W	R	R	R	W
x	R	x	R	x
x	R	x	R	x
W	W	x	W	W
x	x	x	x	x
