x	x	O	O	O	B	x
x	B	B	B	B	B	x
x	B	O	O	O	B	x
x	x	O	O	O	x	x
x	x	x	W	x	x	x
x	x	W	W	W	x	x
x	x	W	P	W	x	x
x	x	W	P	W	x	x
x	x	x	P	x	x	x
x	x	x	W	x	x	x
x	x	x	W	W	x	x
x	x	x	x	x	x	x
