x	x	x	x	x	x	x	x	x	x	x	x	x	x	x
x	x	x	x	x	x	x	x	x	x	x	x	x	x	x
x	x	x	x	x	x	x	x	x	x	x	x	x	x	x
x	x	x	x	x	R	R	R	R	R	x	x	x	x	x
x	x	x	x	R	R	R	R	R	R	R	x	x	x	x
x	x	x	R	R	R	x	x	x	R	R	R	x	x	x
x	x	x	R	R	x	x	x	x	x	R	R	x	x	x
x	x	x	R	R	x	x	x	x	x	R	R	x	x	x
x	x	x	R	R	x	x	x	x	x	R	R	x	x	x
x	x	x	R	R	R	x	x	x	R	R	R	x	x	x
x	x	x	x	R	R	R	R	R	R	R	x	x	x	x
x	x	x	x	x	R	R	R	R	R	x	x	x	x	x
x	x	x	x	x	x	x	x	x	x	x	x	x	x	x
x	x	x	x	x	x	x	x	x	x	x	x	x	x	x
x	x	x	x	x	x	x	x	x	x	x	x	x	x	x
