x	x	x	x	R	R	R	R	R	x	x	x	x
x	x	x	x	R	W	x	W	R	x	x	x	x
x	x	x	x	R	x	x	x	R	x	x	x	x
x	x	x	x	R	R	R	R	R	x	x	x	x
x	x	x	x	x	x	R	x	x	x	x	x	x
x	R	R	R	R	R	R	R	R	R	R	R	x
x	R	x	x	x	x	x	x	x	x	x	R	x
x	R	x	G	G	x	x	x	G	G	x	R	x
x	R	x	G	x	G	x	G	x	G	x	R	x
x	R	x	x	G	G	G	G	G	x	x	R	x
x	R	x	x	x	x	x	x	x	x	x	R	x
x	R	R	R	R	R	R	R	R	R	R	R	x
x	W	B	B	B	W	B	B	B	W	B	B	x
B	x	x	x	x	x	x	x	x	x	x	x	B
x	B	x	x	x	x	x	x	x	x	x	W	x
x	x	B	W	B	B	B	W	B	B	B	x	x
