x	x	x	x	R	R	R	R	R	x	x	x	x
x	x	x	x	R	x	x	x	R	x	x	x	x
x	x	x	x	R	x	x	x	R	x	x	x	x
x	x	x	x	R	R	R	R	R	x	x	x	x
x	x	x	x	x	x	R	x	x	x	x	x	x
x	R	R	R	R	R	R	R	R	R	R	R	x
x	R	x	x	x	x	x	x	x	x	x	R	x
x	R	x	x	G	G	x	G	G	x	x	R	x
x	R	x	G	x	G	x	G	x	G	x	R	x
x	R	x	G	G	x	G	x	G	G	x	R	x
x	R	x	x	x	x	x	x	x	x	x	R	x
x	R	R	R	R	R	R	R	R	R	R	R	x
x	B	B	W	B	B	B	W	B	B	B	W	x
B	x	x	x	x	x	x	x	x	x	x	x	B
x	B	x	x	x	x	x	x	x	x	x	B	x
x	x	B	B	B	W	B	B	B	W	B	x	x
